111111
1XTA1
1M0F1
1C001
11N11
11D11
 111