111111
1XTA1
1M0F1
1C0E1
11011
11D11
 111