11111
1ATB1
1X0M11
1CN0O1
100P11
11D11
11111