11111
1ATB1
1X0M1
1CN01
10001
11D11
11111