111111
1XTA1
1M0F1
1C0N1
11111